111111
1P0C01
1111C1
1000E1
111111
